###############
#             S
#### ##########
###   #########
#####E#########