###########S###
#             #
##### #########
#####    ######
###   #########
#####E#########